00                           []                             
01                           {}                     *       
02       .                   []                             
03                        /-==-=-'      .                 
04                +       (_,_,,_)                         
05                           {}                          .  
06                        /=-==-='                          
07                        (_,,_,_)                         
08              .            []                             
09                           |%                +            
10    +                      .                         .    
11                                                          
12                                      *           +       
13                 +                                        
14                      +                 .                 
15                               *                          
16    .           .                                         
17                                                          
18          *                                             . 
19                   <^^^^^^^>                              
20                   \:::::::;             *                
21     .              []   [] +                             
22                    {}  .{}                              
23         +          []   []                               

